1111111111111111111
100000000000C0000E1
100000P000000000001
100C000000000000001
1000000000C00000001
1111111111111111111
