11111111111111111
100000P00E0000001
1000000000000C001
100000000000V0001
11111111111111111
