1111111111111
1E00C000011
10000P00011
10C00000011
11111111111
