1111111111111
1000001CCECC1
10P0001CCCCC1
1000001CCCCC1
1111111111111
