1111111111111
1000000CC0CC1
1100000CCCCC1
1PE0000000CC1
1111111111111
