1111111111111111111
1110C0000E000C00111
11000000C0000000011
1C00000000000000C01
100000C0000C0000001
1100000000000000011
111C00000P0000C0111
1111111111111111111
