11111111111111111
1P10C0100010001E1
10101010101010101
1000100010C010001
11111111111111111
