11111111111111111
1P100010C010001E1
101C101010101C101
10001C00100C10001
11111111111111111
