111111111111
1C1C111C0001
10000010C101
1C100C0001C1
101101110101
1001C0000101
11011111C101
1EP00C000001
1101111011C1
10C1C000C101
101101111101
1C100000C001
101C11111101
1000C0000C01
111111111111
