11111
1P1E1
10101
10C01
11111
