11111111111
1C000000001
10100C00001
10100011001
1P101100C01
11E01C00001
11111111111
