11111111111
1C000000001
10100C00001
10100011001
10101100C01
1PE00C00001
11111111111
