11111111111
10000P00001
1C1111111C1
1000000C001
101C1111101
1C101E1C001
11101010101
100C10001C1
10101C11101
1C0000C0001
11111111111
