1111111111011111
1000000000000001
1000000000000000
10P0000000000001
1000000000000001
1111101111011111
