11111111111111111
1000000P000000E01
10000000000P00001
10000000000000001
11111111111111111
