11111111111111111
100000000E0000001
1000000000000E001
100P0000000000001
11111111111111111
